xxxxxxxxxxxxxxxxxxxxxxxxxxxxxxxxxxxxxxxxxxxxxxxxxxxxxxxxxxxxxxxxxxxxxxxxxxxxxxxx
x                                                                              x
x                                                                             $x
x                                                                              x
x                                                                              x
x                               $                                             xx
x                                                                              x
x                     $                     x                                  x
x       $                                                   $                  x
x                                                                              x
x                                                                              x
x                                                                              x
x                               x                                              x
x                     x                                                        x
x                                           x                                  x
x       x                                                                      x
x                                                                              x
x                                                                              x
x                                                           x                  x
x                                                                              x
x                                                                              x
x                                                                            k x
x                                                                              x
x                                                                            pdx
xx x x x x x x x x x x x x x x x x x x x x x x x x x x x x x x x x x x x x x xxx