xxxxxxxxxxxxxxxxxxxxxxxxxxxxxxxxxxxxxxxxxxxxxxxxxxxxxxxxxxxxxxxxxxxxxxxxxxxxxxxx
x                                                                              x
x                                    $                                         x
x                                   xxx        xxx                             x
x                                                                              x
x                                                                              x
x                                                                              x
x                                                                              x
x                                                                              x
x                                                                              x
x                                                                              x
x          x   x   x   x   x   x   x   x   x   x   x   x   x   x   x           x
x          x   x   x   x   x   x   x   x   x   x   x   x   x   x   x           x
x          x   x   x   x   x   x   x   x   x   x   x   x   x   x   x           x
x          x   x   x   x   x   x   x   x   x   x   x   x   x   x   x           x
x          x   x   x   x   x   x   x   x   x   x   x   x   x   x   x           x
x          x   x   x   x   x   x   x   x   x   x   x   x   x   x   x           x
x          x   x   x   x   x   x   x   x   x   x   x   x   x   x   x           x
x          x   x   x   x   x   x   x   x   x   x   x   x   x   x   x           x
x          x   x   x   x   x   x   x   x   x   x   x   x   x   x   x           x
x          x $ x   x $ x   x $ x   x $ x   x $ x   x $ x   x $ x   x           x
x          x   x   x   x   x   x   x   x   x   x   x   x   x   x   x           x
x          x   x   x   x   x   x   x   x   x   x   x   x   x   x   x           x
xd k p     x   x   x   x   x   x   x   x   x   x   x   x   x   x   x           x
xxxxxxxx   x   x   x   x   x   x   x   x   x   x   x   x   x   x   x   xxxxxxxxx