xxxxxxxxxxxxxxxxxxxxxxxxxxxxxxxxxxxxxxxxxxxxxxxxxxxxxxxxxxxxxxxxxxxxxxxxxxxxxxxx
x                                                                              x
x                                    $          k                              x
x                                   xxx        xxx                             x
x                                                                              x
x                                                                              x
x                                                                              x
x                                                                              x
x                                                                              x
x                                                                              x
x                                                                              x
x          x   x   x   x   x   x   x   x   x   x   x   x   x   x   x           x
x          x   x   x   x   x   x   x   x   x   x   x   x   x   x   x           x
x          x   x   x   x   x   x   x   x   x   x   x   x   x   x   x           x
x          x   x   x   x   x   x   x   x   x   x   x   x   x   x   x           x
x          x   x   x   x   x   x   x   x   x   x   x   x   x   x   x           x
x          x   x   x   x   x   x   x   x   x   x   x   x   x   x   x           x
x          x   x   x   x   x   x   x   x   x   x   x   x   x   x   x           x
x          x   x   x   x   x   x   x   x   x   x   x   x   x   x   x           x
x          x   x   x   x   x   x   x   x   x   x   x   x   x   x   x           x
x          x $ x   x $ x   x $ x   x $ x   x $ x   x $ x   x $ x   x           x
x          x   x   x   x   x   x   x   x   x   x   x   x   x   x   x           x
x          x   x   x   x   x   x   x   x   x   x   x   x   x   x   x           x
xd         x   x   x   x   x   x   x   x   x   x   x   x   x   x   x        p  x
xxxxxxxx   x   x   x   x   x   x   x   x   x   x   x   x   x   x   x   xxxxxxxxx