xxxxxxxxxxxxxxxxxxxxxxxxxxxxxxxxxxxxxxxxxxxxxxxxxxxxxxxxxxxxxxxxxxxxxxxxxxxxxxxx
x                                                                              x
x                                                                              x
x                                                                              x
x                                                                          $   x
x             x                                                                x
x       x     x                     x   xxx      x    xx    xxx                x
x       xx   xx     xxx     x       x  xx        x     x   xx                  x
x        x  xx     xx xx    xx      x  x         x     x   x                   x
x        x xx     xx   x    xxx     x  xxxxxx    x     xx x                    x
x        x x       x   x    x x    xx       xxxx x     xx xx                   x
x       xxx        x   xx   x xx   x          xx x     x   xxxxxxxx            x
x       x x  $     x    x   x  x  xx          x  xx    x          x            x
x       x xx       xxxxxx   x  xx x       $  x    x $  x          xx           x
x       x  xx      xx   x   xk  xxx xx      xx    x xxxx xx    $   x           x
x       x   xx     x    xx  x    x  xxx   xxx     xxxxx  xx       x            x
x       x    xx    x    xx  x       xx   xx        xxx    xx   xxxx            x
x       x     xx   x        x        xxxxx                 xxxxx               x
x       x      xx  x        x                                                  x
x               x                                                              x
x                                                                              x
x                                                                              x
x                                                                              x
xd                                                                          p  x
xxxxxxxx                                                               xxxxxxxxx