xxxxxxxxxxxxxxxxxxxxxxxxxxxxxxxxxxxxxxxxxxxxxxxxxxxxxxxxxxxxxxxxxxxxxxxxxxxxxxxx
x                            x                k                x               x
x                           $x                               $ x $             x
xd                           x                                 x               x
xxx                                                            x            x  x
xxx            $             x                                              x  x
xxx                          x                                              x  x
xxx                                                                 x       x  x
xxx         xxxxxx           x                                      x       x  x
x           x    x           x                         xx x x  x    x       x  x
x           xxxxxx                            xx               x    x       x  x
x                            x                xx               x            x  x
xxx                          x                xx                            x  x
xxx                                           xx                            x  x
xxx                          x                                 x            x  x
x                            x       x  xx                     x            x  x
x                            x                                              x  x
x                            x                                              x  x
xxx                                                                         x  x
xxx                                           xx                            x  x
xxx                                           xx                            x  x
xxx                                           xx                            x  x
xxx                                           xx                            x px
xxx                                           xx                            x  x
xxxxxxxxx xxx xxx xxx xxx xxxxxxxxxx       xxxxxxxxxxxxxxxxx$xxxxxxxxx      xxxx